You are a scientist in the Jungle searching for the rare Kermit frog. You have been living here for a couple months now and are have just located the tree on which the Kermit frogs live, but your supplies and food are running low. If you don't find the Kermit frog soon, you will have to restart your search after replenishing your supplies.

Jungle Search
An Interactive Fiction by mloo19
Release 1 / Serial number 190304 / Inform 7 build 6M62 (I6/v6.33 lib 6/12N) SD

Jungle Path
Various species of large jungle trees covered in vines surround you. You can hear the caws from the multi-colored birds flying above your head as you walk to the tree where you last saw the Kermit frogs. As you continue walking, you can hear the distinct "Rainbow Connection" call of the Kermit frogs.

The Kermit frog Tree is north of you.

Watch out for quicksand traps!

>climb vines
You swing on the vines like Tarzan to the Kermit Frog Tree where you jump off.

Tree Trunk
You tilt your head backwards to stare up at the 80-foot tall tree. The calls of "Rainbow Connection" are deafening. Flies swarm all around you making it hard to locate the branch that the Kermit Frogs are on. 
 The path you came from is south and the branch of the Kermit Frogs is above you.

>u
You grab onto the lower branches of the tree and start climbing.

Branch
You wipe the sweat from your forehead, tired from your climbing. The Kermit Frogs are all hiding in the nooks of the tree. 
 The way to the path is below you.

You can see a Kermit Frog here.

>take frog
The Kermit Frogs are still hiding. You need to lure them out.

>d
Tree Trunk
You tilt your head backwards to stare up at the 80-foot tall tree. The calls of "Rainbow Connection" are deafening. Flies swarm all around you making it hard to locate the branch that the Kermit Frogs are on. 
 The path you came from is south and the branch of the Kermit Frogs is above you.

>open backpack
You open the backpack, revealing a Scooby snacks, a Water Bottle, a jar and a notebook.

>take jar
You take the jar out of your backpack.

Taken.

>catch flies
You collect some flies into your jar and screw the lid back on.

>put jar in backpack
You put the jar back in your backpack.

>u
You grab onto the lower branches of the tree and start climbing.

Branch
You wipe the sweat from your forehead, tired from your climbing. The Kermit Frogs are all hiding in the nooks of the tree. 
 The way to the path is below you.

You can see a Kermit Frog here.

>release flies
Wait, where are the flies?

>take jar
You take the jar out of your backpack.

Taken.

>release flies
The flies scatter all around you. You can see the Kermit Frogs coming out of their hiding spots because of the tempting food.

>take frog
You caught one!

You win! Now you can go back to your lab and study this amazing creature.

    *** The End ***

Would you like to RESTART, RESTORE a saved game, QUIT or UNDO the last command?

* * *

>grab vines
That's not a verb I recognise.

>hold vines
That's hardly portable.

* * *

>hold vines
You grab onto the vines just in case there is a quicksand trap nearby.

>n
You use the vines to pull yourself through the sticky quicksand laid on the path to the Tree with the Kermit Frogs.

Tree Trunk
You tilt your head backwards to stare up at the 80-foot tall tree. The calls of "Rainbow Connection" are deafening. Flies swarm all around you making it hard to locate the branch that the Kermit Frogs are on. 
 The path you came from is south and the branch of the Kermit Frogs is above you.

>catch flies
You try to catch the flies with your fingers Mr. Miyagi-style, but aren't having much success. Then you remember you have some useful tools in your backpack.

>take jar
You can't see any such thing.

>open backpack
You open the backpack, revealing a Scooby snacks, a Water Bottle, a jar and a notebook.

>take jar
Taken.

>catch flies
You collect some flies into your jar and screw the lid back on.

>put jar in backpack
You put the jar into the backpack.

>u
You grab onto the lower branches of the tree and start climbing.

Branch
You wipe the sweat from your forehead, tired from your climbing. The Kermit Frogs are all hiding in the nooks of the tree. 
 The way to the path is below you.

You can see a Kermit Frog here.

>release flies
You can't see any such thing.

>open backpack
That's already open.

>take jar
Taken.

>release flies
You can't see any such thing.

>x jar
A clear, glass container.  It seems to be empty.

* * *

>n
You use the vines to pull yourself through the sticky quicksand laid on the path to the Tree with the Kermit Frogs.

Tree Trunk
You tilt your head backwards to stare up at the 80-foot tall tree. The calls of "Rainbow Connection" are deafening. Flies swarm all around you making it hard to locate the branch that the Kermit Frogs are on. 
 The path you came from is south and the branch of the Kermit Frogs is above you.

>open backpack
You open the backpack, revealing a Scooby snacks, a Water Bottle, a jar and a notebook.

>catch flies
You try to catch the flies with your fingers Mr. Miyagi-style, but aren't having much success. Then you remember you have some useful tools in your backpack.

>take jar
You take the jar out of your backpack.

Taken.

* * *

>catch flies
You collect some flies into your jar and screw the lid back on.

>u
It is really hard to climb while holding so many things!

>put jar in backpack
You put the jar back in your backpack.

* * *

>u
You grab onto the lower branches of the tree and start climbing.

Branch
You wipe the sweat from your forehead, tired from your climbing. The Kermit Frogs are all hiding in the nooks of the tree. 
 The way to the path is below you.

You can see a Kermit Frog here.

>take jar
You take the jar out of your backpack.

Taken.

* * *

>catch flies
You collect some flies into your jar and screw the lid back on.

>put jar in backpack
You put the jar back in your backpack.

You put the jar into the backpack.

>undo
Tree Trunk
[Previous turn undone.]

>x jar
A clear, glass container.  In the jar you can see a Flies. 

In the jar is a Flies.

>put jar in backpack
You put the jar back in your backpack.

You put the jar into the backpack.

>u
You grab onto the lower branches of the tree and start climbing.

Branch
You wipe the sweat from your forehead, tired from your climbing. The Kermit Frogs are all hiding in the nooks of the tree. 
 The way to the path is below you.

You can see a Kermit Frog here.

* * *

>release flies
The flies scatter all around you. You can see the Kermit Frogs coming out of their hiding spots because of the tempting food.

>take frog
The Kermit Frogs are still hiding. You need to lure them out.

* * *

>n
You use the vines to pull yourself through the sticky quicksand laid on the path to the Tree with the Kermit Frogs.

Tree Trunk
You tilt your head backwards to stare up at the 80-foot tall tree. The calls of "Rainbow Connection" are deafening. Flies swarm all around you making it hard to locate the branch that the Kermit Frogs are on. 
 The path you came from is south and the branch of the Kermit Frogs is above you.

>put flies in jar
You can't see any such thing.

>x me
As good-looking as ever.

>i
You are carrying:
  a vines
  a backpack (being worn and closed)

>open backpack
You open the backpack, revealing a jar and a notebook.

>take jar
Taken.

>put flies in jar
(first taking the Flies)
I don't suppose the Flies would care for that.

* * *

>n
You use the vines to pull yourself through the sticky quicksand laid on the path to the Tree with the Kermit Frogs.

Tree Trunk
You tilt your head backwards to stare up at the 80-foot tall tree. The calls of "Rainbow Connection" are deafening. Flies swarm all around you making it hard to locate the branch that the Kermit Frogs are on. 
 The path you came from is south and the branch of the Kermit Frogs is above you.

>take jar
You can't see any such thing.

>x me
Dressed in some camoflauge khaki and wearing a adventurer's hat and your backpack, you are ready to trek through the Jungle.

>open backpack
You open the backpack, revealing a Scooby snacks, a Water Bottle, a jar and a notebook.

* * *

>take jar
Taken.

>catch flies in jar
I only understood you as far as wanting to catch the Flies.

>undo
Tree
[Previous turn undone.]

>hold jar
You already have that.

>catch flies in jar
I only understood you as far as wanting to catch the Flies.

>catch flies
You collect some flies into your jar and screw the lid back on.

* * *

>i
You are carrying:
  a backpack (being worn and closed)

>x ba
You can't see any such thing.

>l
Jungle Path
Various species of large jungle trees covered in vines surround you. You can hear the caws from the multi-colored birds flying above your head as you walk to the tree where you last saw the Kermit frogs. As you continue walking, you can hear the distinct "Rainbow Connection" call of the Kermit frogs.

The Kermit frog Tree is north of you.

Watch out for quicksand traps!

>walk
You'll have to say which compass direction to go in.

>walk N
"Ahhhhh!" you scream as your legs get sucked into some quicksand. You can feel the pressure increase as you try to grab things to prevent yourself from sinking further into the quicksand.

You sink further and further down until you are fully engulfed by the quicksand and die.

    *** The End ***

Would you like to RESTART, RESTORE a saved game, QUIT or UNDO the last command?

>restart
You are a scientist in the Jungle searching for the rare Kermit frog. You have been living here for a couple months now and are have just located the tree on which the Kermit frogs live, but your supplies and food are running low. If you don't find the Kermit frog soon, you will have to restart your search after replenishing your supplies.

Jungle Search
An Interactive Fiction by mloo19
Release 1 / Serial number 190228 / Inform 7 build 6M62 (I6/v6.33 lib 6/12N) SD

Jungle Path
Various species of large jungle trees covered in vines surround you. You can hear the caws from the multi-colored birds flying above your head as you walk to the tree where you last saw the Kermit frogs. As you continue walking, you can hear the distinct "Rainbow Connection" call of the Kermit frogs.

The Kermit frog Tree is north of you.

Watch out for quicksand traps!

>x trees
Tall trees that are covered in a green moss. Small ferns grow at the base of the trees, and vines hang from the tree branches.

>x vines
Long vines that hang off the trees and touch the ground. They are incredibly strong and sturdy.

>hold vines
You grab onto the vines just in case there is a quicksand trap nearby.

>n
You use the vines to pull yourself through the sticky quicksand laid on the path to the Tree with the Kermit Frogs.

Tree
You tilt your head backwards to stare up at the 80-foot tall tree. The calls of "Rainbow Connection" are deafening. Flies swarm all around you making it hard to locate the branch that the Kermit Frogs are on. 
 The path you came from is south and the branch of the Kermit Frogs is above you.

>x Kermit
You can't see any such thing.

>x tree
You can't see any such thing.

>x Tree
You can't see any such thing.

>x branch
You can't see any such thing.

>walk N
You use the vines to pull yourself through the sticky quicksand laid on the path to the Tree with the Kermit Frogs.

You can't go that way.

>walk W
You can't go that way.

>walk E
You can't go that way.

>walk S
You use the vines to pull yourself through the sticky quicksand laid on the path.

Jungle Path
Various species of large jungle trees covered in vines surround you. You can hear the caws from the multi-colored birds flying above your head as you walk to the tree where you last saw the Kermit frogs. As you continue walking, you can hear the distinct "Rainbow Connection" call of the Kermit frogs.

The Kermit frog Tree is north of you.

Watch out for quicksand traps!

>climb
What do you want to climb?

>climb tree
You can't see any such thing.

>climb vine
Little is to be achieved by that.

>up
You grab onto the lower branches of the tree and start climbing.

You can't go that way.

* * *

>i
You are carrying:
  a backpack (being worn and closed)

>x bag
Your backpack is dark green and filled with a jar, your water bottle, and your favorite Scooby snacks.  Your shoulders ache from wearing it.
It is closed.

>open bag
You open the backpack, revealing a jar.

Quicksand
"Ahhhhh!" you scream as you get sucked into a quicksand trap waist-deep. You can feel the pressure increase as you widly grab things to prevent yourself from sinking further into the quicksand.

* * *

>n
"Ahhhhh!" you scream as your legs get sucked into some quicksand. You can feel the pressure increase as you try to grab things to prevent yourself from sinking further into the quicksand.

You sink further and further down until you are fully engulfed by the quicksand and die.

    *** The End ***

Would you like to RESTART, RESTORE a saved game, QUIT or UNDO the last command?

>restart
You are a scientist in the Jungle searching for the rare Kermit frog. You have been living here for a couple months now and are have just located the tree on which the Kermit frogs live, but your supplies and food are running low. If you don't find the Kermit frog soon, you will have to restart your search after replenishing your supplies.

Jungle Search
An Interactive Fiction by mloo19
Release 1 / Serial number 190304 / Inform 7 build 6M62 (I6/v6.33 lib 6/12N) SD

Jungle Path
Various species of large jungle trees covered in vines surround you. You can hear the caws from the multi-colored birds flying above your head as you walk to the tree where you last saw the Kermit frogs. As you continue walking, you can hear the distinct "Rainbow Connection" call of the Kermit frogs.

The Kermit frog Tree is north of you.

Watch out for quicksand traps!

>s
"Ahhhhh!" you scream as your legs get sucked into some quicksand. You can feel the pressure increase as you try to grab things to prevent yourself from sinking further into the quicksand.

You sink further and further down until you are fully engulfed by the quicksand and die.

    *** The End ***

Would you like to RESTART, RESTORE a saved game, QUIT or UNDO the last command?

>restart
You are a scientist in the Jungle searching for the rare Kermit frog. You have been living here for a couple months now and are have just located the tree on which the Kermit frogs live, but your supplies and food are running low. If you don't find the Kermit frog soon, you will have to restart your search after replenishing your supplies.

Jungle Search
An Interactive Fiction by mloo19
Release 1 / Serial number 190228 / Inform 7 build 6M62 (I6/v6.33 lib 6/12N) SD

Jungle Path
Various species of large jungle trees covered in vines surround you. You can hear the caws from the multi-colored birds flying above your head as you walk to the tree where you last saw the Kermit frogs. As you continue walking, you can hear the distinct "Rainbow Connection" call of the Kermit frogs.

The Kermit frog tree is north of you.

Watch out for quicksand traps!

>x tree
You can't see any such thing.

>w
You can't go that way.

>x trees
Tall trees that are covered in a green moss. Small ferns grow at the base of the trees, and vines hang from the tree branches.

>take vine
You grab onto the vines just in case there is a quicksand trap nearby.

>n
You use the vines to pull yourself through the sticky quicksand laid on the path to the Tree with the Kermit Frogs.

Tree
You tilt your head backwards to stare up at the 80-foot tall tree. The calls of "Rainbow Connection" are deafening. Flies swarm all around you making it hard to locate the branch that the Kermit Frogs are on. 
 The path you came from is south and the branch of the Kermit Frogs is above you.

>u
It is really hard to climb while holding so many things!

>i
You are carrying:
  a vines
  a backpack (being worn and closed)

>open backpack
You open the backpack, revealing a Scooby snacks, a Water Bottle, a jar and a notebook.

>read notebook
Your notebook that you have taken notes in during your search for the rare Kermit Frog. Your most recent notes are "The Kermit Frogs like to eat flies. Kermit Frogs like to live at the top of the Kermit Frog Tree to be close to the Rainbow."

>catch flies
You try to catch the flies with your fingers Mr. Miyagi-style, but aren't having much success. Then you remember you have some useful tools in your backpack.

>catch flies in jar
I only understood you as far as wanting to catch the Flies.

>open jar
It isn't something you can open.

>use jar
That's not a verb I recognise.

>use jar to trap flies
That's not a verb I recognise.

>hold jar
Taken.

>catch flies
You collect some flies into your jar and screw the lid back on.

>use flies
That's not a verb I recognise.

>i
You are carrying:
  a jar
  a vines
  a backpack (being worn and open)
    a Scooby snacks
    a Water Bottle
    a notebook

>u
It is really hard to climb while holding so many things!

>drop vine
Dropped.

>put jar in backpack
You put the jar into the backpack.

>close backpack
You close the backpack.

>u
It is really hard to climb while holding so many things!

I beg your pardon?

>i
You are carrying:
  a backpack (being worn and closed)

>open backpack
You open the backpack, revealing a jar, a Scooby snacks, a Water Bottle and a notebook.

>take jar
Taken.

>drop backpack
(first taking the backpack off)
Dropped.

>i
You are carrying:
  a jar

>u
It is really hard to climb while holding so many things!

>x room
You can't see any such thing.

>x
(the jar)
A clear, glass container.  It seems to be empty.

>x tree
You can't see any such thing.

>x trees
You can't see any such thing.

>put on backpack
(first taking the backpack)
You put on the backpack.

>i
You are carrying:
  a backpack (being worn and open)
    a Scooby snacks
    a Water Bottle
    a notebook
  a jar

>put jar in backpack
You put the jar into the backpack.

* * *

>close backpack
You close the backpack.

>i
You are carrying:
  a backpack (being worn and closed)

>climb tree
You can't see any such thing.

>u
It is really hard to climb while holding so many things!

>drop backpack
(first taking the backpack off)
Dropped.

>u
You grab onto the lower branches of the tree and start climbing.

Branch
You wipe the sweat from your forehead, tired from your climbing. The Kermit Frogs are all hiding in the nooks of the tree. 
 The way to the path is below you.

You can see a Kermit Frog here.

* * *

I beg your pardon?

* * *

>d
Tree
You tilt your head backwards to stare up at the 80-foot tall tree. The calls of "Rainbow Connection" are deafening. Flies swarm all around you making it hard to locate the branch that the Kermit Frogs are on. 
 The path you came from is south and the branch of the Kermit Frogs is above you.

You can see a backpack (closed) and a vines here.

>take jar
You can't see any such thing.

* * *

>x tree
Tall trees that are covered in a green moss. Small ferns grow at the base of the trees, and vines hang from the tree branches.

>x vines
Long vines that hang off the trees and touch the ground. They are incredibly strong and sturdy.

>climb onto vines
You can't see any such thing.

>i
You are carrying:
  a backpack (being worn and closed)

>x backpck
You can't see any such thing.

>oops backpack
Your backpack is dark green and packed with a jar, your water bottle, a notebook, and your favorite Scooby snacks.  Your shoulders ache from wearing it.
It is closed.

>s
"Ahhhhh!" you scream as your legs get sucked into some quicksand. You can feel the pressure increase as you try to grab things to prevent yourself from sinking further into the quicksand.

You sink further and further down until you are fully engulfed by the quicksand and die.

    *** The End ***

Would you like to RESTART, RESTORE a saved game, QUIT or UNDO the last command?

>restart
You are a scientist in the Jungle searching for the rare Kermit frog. You have been living here for a couple months now and are have just located the tree on which the Kermit frogs live, but your supplies and food are running low. If you don't find the Kermit frog soon, you will have to restart your search after replenishing your supplies.

Jungle Search
An Interactive Fiction by mloo19
Release 1 / Serial number 190304 / Inform 7 build 6M62 (I6/v6.33 lib 6/12N) SD

Jungle Path
Various species of large jungle trees covered in vines surround you. You can hear the caws from the multi-colored birds flying above your head as you walk to the tree where you last saw the Kermit frogs. As you continue walking, you can hear the distinct "Rainbow Connection" call of the Kermit frogs.

The Kermit frog Tree is north of you.

Watch out for quicksand traps!

>hold vines
You grab onto the vines just in case there is a quicksand trap nearby.

* * *

>n
You use the vines to pull yourself through the sticky quicksand laid on the path to the Tree with the Kermit Frogs.

Tree Trunk
You tilt your head backwards to stare up at the 80-foot tall tree. The calls of "Rainbow Connection" are deafening. Flies swarm all around you making it hard to locate the branch that the Kermit Frogs are on. 
 The path you came from is south and the branch of the Kermit Frogs is above you.

>up
You grab onto the lower branches of the tree and start climbing.

Branch
You wipe the sweat from your forehead, tired from your climbing. The Kermit Frogs are all hiding in the nooks of the tree. 
 The way to the path is below you.

You can see a Kermit Frog here.

>x frog
You are looking for the elusive vibrant green frog with a long red tounge and a Jester's collar.

>e
You can't go that way.

>down
Tree Trunk
You tilt your head backwards to stare up at the 80-foot tall tree. The calls of "Rainbow Connection" are deafening. Flies swarm all around you making it hard to locate the branch that the Kermit Frogs are on. 
 The path you came from is south and the branch of the Kermit Frogs is above you.

>up
You grab onto the lower branches of the tree and start climbing.

Branch
You wipe the sweat from your forehead, tired from your climbing. The Kermit Frogs are all hiding in the nooks of the tree. 
 The way to the path is below you.

You can see a Kermit Frog here.

>x nook
You can't see any such thing.

>down
Tree Trunk
You tilt your head backwards to stare up at the 80-foot tall tree. The calls of "Rainbow Connection" are deafening. Flies swarm all around you making it hard to locate the branch that the Kermit Frogs are on. 
 The path you came from is south and the branch of the Kermit Frogs is above you.

>n
You use the vines to pull yourself through the sticky quicksand laid on the path to the Tree with the Kermit Frogs.

You can't go that way.

>s
You use the vines to pull yourself through the sticky quicksand laid on the path.

Jungle Path
Various species of large jungle trees covered in vines surround you. You can hear the caws from the multi-colored birds flying above your head as you walk to the tree where you last saw the Kermit frogs. As you continue walking, you can hear the distinct "Rainbow Connection" call of the Kermit frogs.

The Kermit frog Tree is north of you.

Watch out for quicksand traps!

>s
You use the vines to pull yourself through the sticky quicksand laid on the path.

You can't go that way.

>w
You can't go that way.

>n
You use the vines to pull yourself through the sticky quicksand laid on the path to the Tree with the Kermit Frogs.

Tree Trunk
You tilt your head backwards to stare up at the 80-foot tall tree. The calls of "Rainbow Connection" are deafening. Flies swarm all around you making it hard to locate the branch that the Kermit Frogs are on. 
 The path you came from is south and the branch of the Kermit Frogs is above you.

* * *

>up
You grab onto the lower branches of the tree and start climbing.

Branch
You wipe the sweat from your forehead, tired from your climbing. The Kermit Frogs are all hiding in the nooks of the tree. 
 The way to the path is below you.

You can see a Kermit Frog here.

>get frog
You caught one!

You win! Now you can go back to your lab and study this amazing creature.

    *** The End ***

Would you like to RESTART, RESTORE a saved game, QUIT or UNDO the last command?

* * *

>take kermit frog
You can't see any such thing.

* * *

>take vines
You grab onto the vines just in case there is a quicksand trap nearby.

>n
You use the vines to pull yourself through the sticky quicksand laid on the path to the Tree with the Kermit Frogs.

Tree Trunk
You tilt your head backwards to stare up at the 80-foot tall tree. The calls of "Rainbow Connection" are deafening. Flies swarm all around you making it hard to locate the branch that the Kermit Frogs are on. 
 The path you came from is south and the branch of the Kermit Frogs is above you.

* * *

>take jar
You take the jar out of your backpack.

Taken.

>eat snacks
(first taking the Scooby snacks)
"Mmmm, delicious," you say. You wish you had more, but your supplies are slowly depleting, so you must pace yourself.

>catch flies
You collect some flies into your jar and screw the lid back on.

* * *

>release flies
The flies scatter all around you. You can see the Kermit Frogs coming out of their hiding spots because of the tempting food.

>take frog
You caught one!

I don't suppose the Kermit Frog would care for that.

* * *

>x jungle trees
Tall trees that are covered in a green moss. Small ferns grow at the base of the trees, and vines hang from the tree branches.

>x vine
You can't see any such thing.

* * *

>x me
Dressed in some camoflauge khaki and wearing a adventurer's hat and your backpack, you are ready to trek through the Jungle.

>i
You are carrying:
  a backpack (being worn and closed)

>x backpack
Your backpack is dark green and packed with a jar, your water bottle, a notebook, and your favorite Scooby snacks.  Your shoulders ache from wearing it.
It is closed.

>x notebook
You can't see any such thing.

>open backpack
You open the backpack, revealing a Scooby snacks, a Water Bottle, a jar and a notebook.

>x notebook
Your notebook that you have taken notes in during your search for the rare Kermit Frog. Your most recent notes are "The Kermit Frogs like to eat flies. Kermit Frogs like to live at the top of the Kermit Frog Tree to be close to the Rainbow."

* * *

>x me
Dressed in some camoflauge khaki and wearing a adventurer's hat and your backpack, you are ready to trek through the Jungle.

>x backpack
Your backpack is dark green and filled with a jar, your water bottle, a notebook, and your favorite Scooby snacks.  Your shoulders ache from wearing it.
It is closed.

>drink water
You can't see any such thing.

>drink water bottle
You can't see any such thing.

* * *

>x backpack
Your backpack is dark green and filled with a jar, your water bottle, a notebook, and your favorite Scooby snacks.  Your shoulders ache from wearing it.
It is closed.

>x water bottle
You can't see any such thing.

>x scooby snacks
You can't see any such thing.

>eat snacks
You can't see any such thing.

>x notebook
You can't see any such thing.

* * *

>open backpack
You open the backpack, revealing a Scooby snacks, a Water Bottle, a jar and a notebook.

>drink water
There's nothing suitable to drink here.

>eat snacks
(first taking the Scooby snacks)
"Mmmm, delicious," you say. You wish you had more, but your supplies are slowly depleting, so you must pace yourself.

>x notebook
Your notebook that you have taken notes in during your search for the rare Kermit Frog. Your most recent notes are "The Kermit Frogs like to eat flies. Kermit Frogs like to live at the top of the Kermit Frog Tree to be close to the Rainbow."

* * *

>x vine
You can't see any such thing.

* * *

>x vines
Long vines that hang off the trees and touch the ground. They are incredibly strong and sturdy.

>x tree
You can't see any such thing.

>x jungle trees
Tall trees that are covered in a green moss. Small ferns grow at the base of the trees, and vines hang from the tree branches.

* * *

>x vines
Long vines that hang off the trees and touch the ground. They are incredibly strong and sturdy.

>x trees
Tall trees that are covered in a green moss. Small ferns grow at the base of the trees, and vines hang from the tree branches.

>hold vines
You grab onto the vines just in case there is a quicksand trap nearby.

Taken.

>n
You use the vines to pull yourself through the sticky quicksand laid on the path to the Tree with the Kermit Frogs.

Tree
You tilt your head backwards to stare up at the 80-foot tall tree. The calls of "Rainbow Connection" are deafening. Flies swarm all around you making it hard to locate the branch that the Kermit Frogs are on. 
 The path you came from is south and the branch of the Kermit Frogs is above you.

>open backpack
You open the backpack, revealing a Scooby snacks, a Water Bottle, a jar and a notebook.